Variable_name	Value
SQL_AUTO_IS_NULL	false
activate_all_roles_on_login	false
allow_hive_without_partition_filter	true
analyze_mv	
ann_params	
array_low_cardinality_optimize	true
audit_execute_stmt	false
auto_increment_increment	1
autocommit	true
back_pressure_back_rounds	3
back_pressure_throttle_time_upper_bound	300
big_query_log_cpu_second_threshold	480
big_query_log_scan_bytes_threshold	10737418240
big_query_log_scan_rows_threshold	1000000000
big_query_profile_threshold	30s
broadcast_row_limit	15000000
catalog	default_catalog
cbo_cte_force_reuse_node_count	2000
cbo_cte_reuse	true
cbo_derive_join_is_null_predicate	true
cbo_derive_range_join_predicate	false
cbo_enable_intersect_add_distinct	true
cbo_enable_low_cardinality_optimize	true
cbo_eq_base_type	decimal
cbo_json_v2_dict_opt	true
cbo_json_v2_rewrite	true
cbo_max_reorder_node_use_dp	10
cbo_max_reorder_node_use_exhaustive	4
cbo_max_reorder_node_use_greedy	16
cbo_prepare_metadata_thread_pool_size	16
cbo_prune_json_subfield	true
cbo_push_down_aggregate_with_multi_column_stats	true
cbo_push_down_distinct_below_window	true
cbo_push_down_distinct_limit	4096
cbo_push_down_topn_limit	1000
cbo_reorder_threshold_use_exhaustive	6
cbo_use_correlated_predicate_estimate	true
character_set_client	utf8
character_set_connection	utf8
character_set_database	utf8
character_set_results	utf8
character_set_server	utf8
choose_execute_instances_mode	LOCALITY
cngroup_schedule_mode	standard
collation_connection	utf8_general_ci
collation_database	utf8_general_ci
collation_server	utf8_general_ci
column_view_concat_bytes_limit	4294967296
column_view_concat_rows_limit	-1
computation_fragment_scheduling_policy	COMPUTE_NODES_ONLY
connector_huge_file_size	536870912
connector_incremental_scan_ranges_size	500
connector_io_tasks_per_scan_operator	16
connector_max_split_size	67108864
connector_scan_use_query_mem_ratio	0.3
connector_sink_compression_codec	uncompressed
connector_sink_target_max_file_size	1073741824
count_distinct_column_buckets	1024
count_distinct_implementation	default
custom_query_id	
datacache_sharing_work_period	600
default_rowset_type	alpha
default_storage_engine	InnoDB
default_table_compression	lz4_frame
default_tmp_storage_engine	InnoDB
disable_colocate_join	false
disable_colocate_set	false
disable_join_reorder	false
disable_spill_to_local_disk	false
div_precision_increment	4
dynamic_overwrite	false
enable_adaptive_sink_dop	true
enable_array_distinct_after_agg_opt	true
enable_big_query_log	true
enable_bucket_aware_execution_on_lake	true
enable_cbo_based_mv_rewrite	true
enable_cbo_table_prune	false
enable_cbo_view_based_mv_rewrite	false
enable_collect_table_level_scan_stats	true
enable_color_explain_output	true
enable_connector_adaptive_io_tasks	true
enable_connector_async_list_partitions	false
enable_connector_deploy_scan_ranges_background	true
enable_connector_incremental_scan_ranges	true
enable_connector_sink_writer_scaling	true
enable_connector_split_io_tasks	true
enable_constant_execute_in_fe	true
enable_count_distinct_rewrite_by_hll_bitmap	true
enable_cross_join	true
enable_datacache_async_populate_mode	true
enable_datacache_io_adaptor	true
enable_datacache_sharing	true
enable_defer_project_after_topn	true
enable_delta_lake_column_statistics	false
enable_dialect_downgrade	true
enable_distinct_column_bucketization	false
enable_drop_table_check_mv_dependency	false
enable_dynamic_prune_scan_range	true
enable_eliminate_agg	true
enable_evaluate_schema_scan_rule	true
enable_file_metacache	true
enable_file_pagecache	true
enable_filter_unused_columns_in_scan_stage	true
enable_fine_grained_range_predicate	false
enable_force_rule_based_mv_rewrite	true
enable_gin_filter	true
enable_global_runtime_filter	true
enable_group_by_compressed_key	true
enable_group_execution	true
enable_group_level_query_queue	false
enable_groupby_use_output_alias	false
enable_hash_join_linear_chained_opt	true
enable_hash_join_range_direct_mapping_opt	true
enable_hive_column_stats	true
enable_hive_metadata_cache_with_insert	false
enable_hyperscan_vec	true
enable_iceberg_column_statistics	false
enable_iceberg_identity_column_optimize	true
enable_incremental_mv	false
enable_inner_join_to_semi	true
enable_insert_strict	true
enable_join_reorder_before_deduplicate	false
enable_lake_tablet_internal_parallel	true
enable_lambda_pushdown	true
enable_load_profile	false
enable_local_shuffle_agg	true
enable_materialized_view_agg_pushdown_rewrite	true
enable_materialized_view_concurrent_prepare	true
enable_materialized_view_for_insert	false
enable_materialized_view_multi_stages_rewrite	true
enable_materialized_view_rewrite	true
enable_materialized_view_rewrite_greedy_mode	false
enable_materialized_view_text_match_rewrite	true
enable_materialized_view_timeseries_agg_pushdown_rewrite	true
enable_materialized_view_transparent_union_rewrite	true
enable_materialized_view_union_rewrite	true
enable_materialized_view_view_delta_rewrite	true
enable_metadata_profile	false
enable_min_max_optimization	true
enable_multicolumn_global_runtime_filter	true
enable_mv_planner	false
enable_nested_loop_join	true
enable_optimize_skew_join_by_broadcast_skew_values	false
enable_optimize_skew_join_by_query_rewrite	true
enable_outer_join_reorder	true
enable_paimon_column_statistics	false
enable_parallel_merge	true
enable_parallel_prepare_metadata	false
enable_parquet_reader_bloom_filter	true
enable_parquet_reader_page_index	true
enable_partition_hash_join	true
enable_per_bucket_optimize	true
enable_phased_scheduler	false
enable_pipeline_engine	true
enable_pipeline_event_scheduler	true
enable_pipeline_level_multi_partitioned_rf	false
enable_plan_advisor	true
enable_plan_advisor_blacklist	true
enable_plan_capture	false
enable_plan_serialize_concurrently	true
enable_predicate_move_around	true
enable_predicate_reorder	false
enable_prepare_stmt	true
enable_profile	false
enable_prune_complex_types	true
enable_prune_complex_types_in_unnest	true
enable_prune_iceberg_manifest	true
enable_push_down_pre_agg_with_rank	true
enable_query_cache	false
enable_query_dump	false
enable_query_history	false
enable_query_queue_load	false
enable_query_queue_select	false
enable_query_queue_statistic	false
enable_query_tablet_affinity	false
enable_query_trigger_analyze	true
enable_rbo_table_prune	false
enable_read_iceberg_equality_delete_with_partition_evolution	false
enable_read_iceberg_puffin_ndv	true
enable_result_sink_accumulate	true
enable_rewrite_bitmap_union_to_bitamp_agg	true
enable_rewrite_groupingsets_to_union_all	false
enable_rewrite_or_to_union_all_join	false
enable_rewrite_partition_column_minmax	true
enable_rewrite_simple_agg_to_hdfs_scan	true
enable_rewrite_simple_agg_to_meta_scan	false
enable_rewrite_sum_by_associative_rule	true
enable_rewrite_unnest_bitmap_to_array	true
enable_runtime_adaptive_dop	false
enable_scan_datacache	true
enable_shared_scan	false
enable_short_circuit	false
enable_sort_aggregate	false
enable_spill	false
enable_spill_to_remote_storage	false
enable_spm_rewrite	false
enable_stats_to_optimize_skew_join	false
enable_strict_order_by	true
enable_subfield_no_copy	true
enable_sync_materialized_view_rewrite	true
enable_table_name_case_insensitive	false
enable_table_prune_on_update	false
enable_tablet_internal_parallel	true
enable_tde	false
enable_topn_runtime_filter	true
enable_ukfk_join_reorder	false
enable_ukfk_opt	false
enable_view_based_mv_rewrite	true
enable_wait_dependent_event	false
enable_write_hive_external_table	false
event_scheduler	OFF
force_schedule_local	false
forward_to_leader	false
full_sort_late_materialization	true
group_concat_max_len	1024
group_execution_group_scale	64
group_execution_max_groups	128
group_execution_min_scan_rows	5000000
hash_join_push_down_right_table	true
historical_nodes_min_update_interval	600
hive_partition_stats_sample_size	3000
hive_temp_staging_dir	/tmp/starrocks
hudi_mor_force_jni_reader	false
init_connect	
innodb_read_only	true
insert_local_shuffle_for_window_pre_agg	true
insert_max_filter_ratio	0.0
insert_timeout	14400
interactive_timeout	3600
interleaving_group_size	10
io_tasks_per_scan_operator	4
jit_level	1
join_implementation_mode_v2	auto
join_late_materialization	false
join_reorder_driving_table_max_element	5
k_factor	1.0
lake_bucket_assign_mode	balance
language	/starrocks/share/english/
large_decimal_underlying_type	panic
license	Apache License 2.0
like_predicate_consolidate_min	2
load_mem_limit	0
load_transmission_compression_type	NO_COMPRESSION
log_rejected_record_num	0
low_cardinality_optimize_on_lake	false
low_cardinality_optimize_v2	true
lower_case_table_names	0
lower_upper_support_utf8	false
materialized_view_max_relation_mapping_size	10
materialized_view_rewrite_mode	DEFAULT
materialized_view_subuqery_text_match_max_count	4
materialized_view_union_rewrite_mode	0
max_allowed_packet	33554432
max_or_to_union_all_join_predicates	3
max_parallel_scan_instance_num	-1
max_pipeline_dop	64
max_pushdown_conditions_per_column	-1
max_scan_key_num	-1
metadata_collect_query_timeout	60
nested_mv_rewrite_max_level	3
net_buffer_length	16384
net_read_timeout	60
net_write_timeout	60
new_planner_agg_stage	0
new_planner_optimize_timeout	3000
optimizer_materialized_view_timelimit	1000
orc_use_column_names	false
paimon_force_jni_reader	false
parallel_exchange_instance_num	-1
parallel_fragment_exec_instance_num	1
parallel_merge_late_materialization_mode	auto
parse_tokens_limit	3500000
partial_update_mode	auto
performance_schema	false
phased_scheduler_max_concurrency	2
pipeline_dop	0
pipeline_profile_level	1
pipeline_sink_dop	0
plan_capture_include_pattern	.*
plan_capture_interval_seconds	10800
plan_mode	auto
populate_datacache_mode	auto
pq_refine_factor	1.0
prefer_compute_node	false
query_cache_agg_cardinality_limit	5000000
query_cache_entry_max_bytes	4194304
query_cache_entry_max_rows	409600
query_cache_force_populate	false
query_cache_hot_partition_num	3
query_cache_size	1048576
query_cache_type	0
query_delivery_timeout	300
query_history_keep_seconds	259200
query_history_load_interval_seconds	900
query_mem_limit	0
query_queue_concurrency_limit	0
query_queue_cpu_used_permille_limit	0
query_queue_driver_high_water	-1
query_queue_driver_low_water	-1
query_queue_fresh_resource_usage_interval_ms	5000
query_queue_max_queued_queries	1024
query_queue_mem_used_pct_limit	0.0
query_queue_pending_timeout_second	300
query_timeout	300
range_pruner_max_predicate	100
resource_group	
runtime_filter_on_exchange_node	false
runtime_join_filter_push_down_limit	1024000
runtime_profile_report_interval	10
scan_hive_partition_num_limit	0
scan_olap_partition_num_limit	0
scan_use_query_mem_ratio	0.3
semi_join_deduplicat_mode	0
skip_local_disk_cache	false
skip_page_cache	false
spill_enable_direct_io	false
spill_encode_level	7
spill_mode	auto
spill_partitionwise_agg	false
spill_revocable_max_bytes	0
spill_storage_volume	
sql_dialect	StarRocks
sql_mode	ONLY_FULL_GROUP_BY
sql_quote_show_create	true
sql_safe_updates	0
sql_select_limit	9223372036854775807
storage_engine	olap
streaming_preaggregation_mode	auto
system_time_zone	Asia/Shanghai
thrift_plan_protocol	binary
time_zone	Asia/Shanghai
topn_filter_back_pressure_mode	0
transaction_isolation	REPEATABLE-READ
transaction_read_only	false
transmission_compression_type	AUTO
transmission_encode_level	7
tx_isolation	REPEATABLE-READ
tx_visible_wait_timeout	10
use_compute_nodes	-1
use_page_cache	true
version	8.0.33
version_comment	4.0.0-dccb665
wait_timeout	28800
warehouse	default_warehouse
